10 15
0 1 0 7 8 9 10 1 1 0
2 2 2 7 8 9 10 6 6 6
3 3 3 7 8 9 10 6 6 6
4 4 4 7 8 9 10 6 6 6
5 5 5 7 8 9 10 0 1 1
6 6 6 7 8 9 10 1 0 0
6 6 6 7 8 9 10 1 1 1
6 6 6 7 8 9 10 2 2 2
0 1 1 7 8 9 10 3 3 3
1 0 1 7 8 9 10 0 0 1
0 1 1 7 8 9 10 1 0 1
6 1 1 7 8 9 10 4 4 4
6 6 1 7 8 9 10 5 5 5
6 6 6 7 8 9 10 1 1 1
6 6 6 7 8 9 10 1 0 0

